XXXXXXXXXXXXXXXXXXXXXXXXXXXXXXXXXXXXXXXXXXXXXXXXXXXXXX
XXXXXXXXXXXXXXXXXXXXXXXXXXXXXXXXXXXXXXXXXXXXXXXXXXXXXX
XXXXXXXXXXXXXXXXXXXXXXXXXXXXXXXXXXXXXXXXXXXXXXXXXXXXXX
XXXXXXXXXXXXXXXXXXXXXXXXXXXXXXXXXXXXXXXXXXXXXXXXXXXXXX
XXXXXXXXXXXXXXXXXXXXXXXXXXXXXXXXXXXXXXXXXXXXXXXXXXXXXX
XXXXXXXXXXXXXXXXXXXXXXXXXXXXXXXXXXXXXXXXXXXXXXXXXXXXXX
XXXXXXXXXXXXXXXXXXXXXXXXXXXXXXXXXXXXXXXXXXXXXXXXXXXXXX
XXXXXXXXXXXXXXXXXXXXXXXXXXXXXXXXXXXXXXXXXXXXXXXXXXXXXX
XXXXXXXX.XXXXXXXXXXXXXXXXXXXXX...X.XXXXXX...XXXXXXXXXX
XXXXXXXX.XXXXXXXXXXXXXXXXXXXXX...X..........XXXXXXXXXX
XXXXXXXX.X..XX..XX..XXXXXXXX.X..............XXXXXXXXXX
XXXXXXXX................XXX........X.XXX.XXXXXXXXXXXXX
XXXXXXXX...........................X.XXX.XXXXXXXXXXXXX
XXXXXXXXXXXXXXXXXXX.........................XXXXXXXXXX
XXXXXXXXXXXXXXXXXXX.........................XXXXXXXXXX
XXXXXXXXXXXXXXXXXXX.........................XXXXXXXXXX
XXXXXXXXXXXXXXXXXXX.........................XXXXXXXXXX
XXXXXXXXXXXXXXXXXXX.........................XXXXXXXXXX
XXXXXXXXXXXXXXXXXXX.........................XXXXXXXXXX
XXXXXXXXXXXXXXXXXXX.........................XXXXXXXXXX
XXXXXXXXXXXXXXXXXXXXXXXX....XXXXXXXXXXXXXXXXXXXXXXXXXX
XXXXXXXXXXXXXXXXXXXXXXXX....XXXXXXXXXXXXXXXXXXXXXXXXXX
XXXXXXXXXXXXXXXXXXXXXXXX....XXXXXXXXXXXXXXXXXXXXXXXXXX
XXXXXXXXXXXXXXXXXXXXXXXX....XXXXXXXXXXXXXXXXXXXXXXXXXX
XXXXXXXXXXXXXXXXXXXXXXXX....XXXXXXXXXXXXXXXXXXXXXXXXXX
XXXXXXXXXXXXXXXXXXXXXXXX....XXXXXXXXXXXXXXXXXXXXXXXXXX
XXXXXXXXXXXXXXXXXXXXXXXX....XXXXXXXXXXXXXXXXXXXXXXXXXX
X.......XXXXXXXXXXXXXXXX....XXXXXXXXXXXXXXXXXXXXXXXXXX
X.............X.....XX.......XXXXXXXXXXXXXXXXXXXXXXXXX
XXXX..XXX....................XXX.XXXXXXXXX..XXXXXXXXXX
XXXX..XXXX...X...................XXXXXXXXX..XXXXXXXXXX
XXXX..XXXX...X..............................XXXXXXXXXX
XXXX..X..X...X......................XXXXXXXXXXXXXXXXXX
XXXX..X..X.............XX...........XXXXXXXXXXXXXXXXXX
XXXXX.....XXX..........XX.........X..XXXXXXXXXXXXXXXXX
XXXXX.....XXX..........XX.........X...XXXXXXXXXXXXXXXX
XXXX.X.X..X................X.X.........XXXXXXXXXXXXXXX
XXXX.X.X...................X.X..........XXXXXXXXXXXXXX
XXXX.X.X................X....XX.X....X..XXXXXXXXXXXXXX
XXXX....................X.......X....X...XXXXXXXXXXXXX