XXXXXXXXXXXXXXXXXXXXXXXXXXXXXXXXXXXXXXXXXXXXXXXXXXXXXX
XXXXXXXXXXXXXXXXXXXXXXXXXXXXXXXXXXXXXXXXXXXXXXXXXXXXXX
XXXXXXXXXXXXXXXXXXXXXXXXXXXXXXXXXXXXXXXXXXXXXXXXXXXXXX
XXXXXXXXXXXXXXXXXXXXXXXXXXXXXXXXXXXXXXXXXXXXXXXXXXXXXX
XXXXXXXXXXXXXXXXXXXXXXXXXXXXXXXXXXXXXXXXXXXXXXXXXXXXXX
XXXXXXXXXXXXXXXXXXXXXXXXXXXXXXXXXXXXXXXXXXXXXXXXXXXXXX
XXXXXXXXXXXXXXXXXXXXXXXXXXXXXXXXXXXXXXXXXXXXXXXXXXXXXX
XXXXXXXXXXXXXXXXXXXXXXXXXXXXXXXXXXXXXXXXXXXXXXXXXXXXXX
XXXXXXXX.XXXXXXXXXXXXXXXXXXXXX...X.XXXXXX..XXXXXXXXXXX
XXXXXXXX.XXXXXXXXXXXXXXXXXXXXX...X..........XXXXXXXXXX
XXXXXXXX.X..XX..XX..XXXXXXXX.X..............XXXXXXXXXX
XXXXXXXX................XXX........X.XXX.XXXXXXXXXXXXX
XXXXXXXX...........................X.XXX.XXXXXXXXXXXXX
XXXXXXXXXXXXXXXXXXX.......................X.XXXXXXXXXX
XXXXXXXXXXXXXXXXXXX.........................XXXXXXXXXX
XXXXXXXXXXXXXXXXXXX....................X....XXXXXXXXXX
XXXXXXXXXXXXXXXXXXX....................X....XXXXXXXXXX
XXXXXXXXXXXXXXXXXXX.......................XXXXXXXXXXXX
XXXXXXXXXXXXXXXXXXX.XXX......XXX..........XXXXXXXXXXXX
XXXXXXXXXXXXXXXXXXX.XXXX....XXXX............XXXXXXXXXX
XXXXXXXXXXXXXXXXXXXXXXXX....XXXXXXXXXXXXXXXXXXXXXXXXXX
XXXXXXXXXXXXXXXXXXXXXXXX....XXXXXXXXXXXXXXXXXXXXXXXXXX
XXXXXXXXXXXXXXXXXXXXXXXX....XXXXXXXXXXXXXXXXXXXXXXXXXX
XXXXXXXXXXXXXXXXXXXXXXXX....XXXXXXXXXXXXXXXXXXXXXXXXXX
XXXXXXXXXXXXXXXXXXXXXXXX....XXXXXXXXXXXXXXXXXXXXXXXXXX
XXXXXXXXXXXXXXXXXXXXXXXX....XXXXXXXXXXXXXXXXXXXXXXXXXX
XXXXXXXXXXXXXXXXXXXXXXXX....XXXXXXXXXXXXXXXXXXXXXXXXXX
X.......XXXXXXXXXXXXXXXX....XXXXXXXXXXXXXXXXXXXXXXXXXX
X.............X.....XX.......XXXXXXXXXXXXXXXXXXXXXXXXX
XXXX..XXX....................XXXXXXXXXXXXX..XXXXXXXXXX
XXXX..XXXX...X...................XXXXXXXXX..XXXXXXXXXX
XXXX..XXXX...X..............................XXXXXXXXXX
XXXX..XXXX...X.....................XXXXXXXXXXXXXXXXXXX
XXXX..X..X.............XX...........XXXXXXXXXXXXXXXXXX
XXXXX.....XXX..........XX.........X..XXXXXXXXXXXXXXXXX
XXXXX.....XXX..........XX.........X...XXXXXXXXXXXXXXXX
XXXXXX.X..X................X.X.........XXXXXXXXXXXXXXX
XXXXXX.X...................X.X..........XXXXXXXXXXXXXX
XXXXXX.X................X....XX.X....X..XXXXXXXXXXXXXX
XXXXX...................X.......X....X...XXXXXXXXXXXXX