XXXXXX.X..X................X.X.........XXXXXXXXXXXXXXX
XXXXXX.X...................X.X..........XXXXXXXXXXXXXX
XXXXXX.X..............X.X....XX.X....X..XXXXXXXXXXXXXX
XXXXX................XX.X.......X....X...XXXXXXXXXXXXX
....X...............XX......XX............XXXXXXXXXXXX
....XX..............XX......XX............XXXXXXXXXXXX
..XXXX............XXX.X...........X........XXXXXXXXXXX
.XX...............XX.............X..X..........XXXXXXX
XX.........................X...X....X............XXXXX
......................X....X..XXX.................XXXX
.....................XXX...X........................XX
..............XXXX..XX..XX..........................XX
..............XXX.......XX............................
......................................................
......................................................
XX....................................................
......................................................
......................................................
.X...X................................................
..XX..................................................
......................................................
XX....................................................
XX.X..................................................
..XXXXX...............................................
.....XXX..............................................
..X..X.X...XX..........X..............................
.XXX..XXX..................X..XX......................
.....XX.......X....X.......X..........X...............
.....XX........X...XX.................X...............
XX.........X...XXX...............X..X...X.............
XX.X....X.XXX...XX............X..XX....XX.............
...XX........X.XX..X.........XX...X..X....X....XX.....
.............XXXX...............X....XXX..X........XX.